OCF = "countries/Oceanic_Federation.txt"    #大洋联邦
INP = "countries/Indigenous_peoples.txt"    #原住民
EIA = "countries/East_Island_Alliance.txt"    #东岛联盟
CKR = "countries/Cape_Kashgar_Revolutionary_Front.txt"    #卡仕角革命阵线
OMS = "countries/Ocean_Magic_Society.txt"    #彼岸洋魔法协会

KWA = "countries/KWA.txt"   #克拉达斯工人协会
KCU = "countries/KCU.txt"   #克拉达斯市民联合


CID = "countries/CID.txt"   #寒岛联盟
BFS = "countries/BFS.txt"   #彼岸花科考站
FNC = "countries/Federal_Navy_Command.txt"   #联邦海军指挥部
FNR = "countries/Federal_Repulse.txt"   #海雾第二舰队
ANA = "countries/anarchic.txt"   #无政府地区

#无政府乱战（经济崩溃）
OFC = "countries/Orandoka_Free_City.txt"   #欧兰多卡自由市
KEZ = "countries/Kradas_Emergency_Zone.txt"   #克拉达斯应急区
SIE = "countries/Siesta.txt"   #汐斯塔
FLA = "countries/Flanders.txt"   #佛兰斯拉
KCL = "countries/Kashi_Cape_Legion.txt"   #卡仕角军团
KGF = "countries/Kashi_Guerrilla_forces.txt"   #卡仕角游击队
ROM = "countries/Republic_of_Morava.txt"   #莫拉瓦共和国
TKD = "countries/Transylvania_kingdom.txt"   #第三王国
GFZ = "countries/Green_Field_Free_Zone.txt"   #绿野自由区
BRI = "countries/Bujumbura_Research_Institute.txt"   #布琼布拉科研所

#失去领土
BRG = "countries/BRG.txt"


#条约区域
FTB = "countries/FTB.txt" #佛兰斯拉港占领区
KTB = "countries/KTB.txt" #卡仕角港占领区
KMA = "countries/KMA.txt" #克拉达斯占领区





#欧罗巴（占领区）
TFD = "countries/Transylvania_Federal_District.txt" #特兰西瓦尼亚联邦管区
VFD = "countries/Valencia_Federal_District.txt" #瓦拉几亚联邦管区
UFD = "countries/Uruk_Federal_District.txt" #乌鲁克联邦管区
KFD = "countries/Kalpo_Federal_District.txt" #卡尔波联邦管区
VID = "countries/Vilaine_Federal_District.txt" #薇莱娜联邦管区
VAD = "countries/Viva_Federal_District.txt" #维瓦联邦管区
AFD = "countries/Eleanor_Federal_District.txt" #爱丽诺特区
ALD = "countries/Alps_Federal_District.txt" #阿尔卑斯联邦管区
RFD = "countries/Red_Sail_Federal_District.txt" #红帆联邦管区
BFD = "countries/Bernegatte_Federal_District.txt" #伯尼盖特联邦管区
BAD = "countries/Bailin_Federal_District.txt" #柏霖特区
LFD = "countries/Lai_Sakura_Federal_District.txt" #莱樱特联邦管区
RED = "countries/Resembool_Federal_District.txt" #里森堡联邦管区
CFD = "countries/camelot_Federal_District.txt" #卡美洛特区
AGD = "countries/Angelia_Federal_District.txt" #昂格利亚联邦管区
AAD = "countries/alaar_Federal_District.txt" #艾拉尔联邦管区


#美乐蒂（占领区）
ARM = "countries/ARM.txt" #艾诺尔米塔(圆环之理教会改憧憬成为魔法少女)